[level]
tileset = tileset.png
map = ............................................
      .#####.##...................................
      .#...#..#...................................
      .#...####...................................
      .##.##......................................
      .............................t..............
      .............t..............................
      .............g..............................
      ............................................
      ............................................
      ............................................
      ............................................
      .................................ddd........
      ...............t................ddgdd.......
      .................................dddd.......
      ..................................dd........
      ............................................
      ............................................
      ............................................
      ..................g.........................
      ............................................
      ............................................
      ............................................
      ...............................t............
      ............................................
      ............................................
      .......ttt..................................
      .....ttttt..................................
      ......ttttt.................................
      .....ttttttt................................
      ......t.ttt.................................
      ............................................
      ............................................
      ............................................

[.]
name = floor
tile = 0, 1

[#]
name = floor_2
tile = 0, 0

[t]
name = tree
tile = 0, 4
tree = true
block = true

[g]
name = goldmine
tile = 0, 1
sprite = GoldMine.png

[d]
name = dirt
tile = 6, 0