[level]
tileset = tileset.png
map = .............................t..............
      .............t..............................
      .............g..............................
      ............................................
      ............................................
      ............................................
      ............................................
      ............................................
      ............................................
      ............................................
      ............................................
      ..................g.........................
      ............................................
      ............................................
      ............................................
      ...............................t............
      ............................................
      ............................................
      .......ttt..................................
      .....ttttt..................................
      ......ttttt.................................
      .....ttttttt................................
      ......t.ttt.................................
      ............................................
      ............................................
      ............................................

[.]
name = floor
tile = 0, 1

[a]
name = alternate_floor
tile = 1, 1

[t]
name = tree
tile = 0, 4
block = true
overlay = 0, 3

[g]
name = goldmine
tile = 0, 1
sprite = GoldMine.png